---
1.02 - World Design
---
#########
#       #
# @     #
#       #
#       #
#########